#######
#     #
#.****##
#      #
####   #
   #$$.#
   #@ ##
   ####