#######
#     ######
# #$#$     #
#   #  # # #
#.#.#$$$$$@#
# .       ##
#.#.#######
#. .#
#####