----#####
----#---#
----#---#
--###---##
--#------#
###-#-##-#---######
#---#-##-#####----#
#----$-----------.#
#####-###-#@##----#
----#-----#########
----#######