      ####
 ######  #
 #@$   $ #
 #.#     #
##    ####
# .  ##
#   ##
#####