#####
#   ##
#    #
## .@#
## .$##
#  #  #
#  $  #
#  #  #
#######