############-######
#---#----#-###....#
#---$$#---@--.....#
#---#-###---#-....#
##-##-###--#--....#
-#-$-$-----#-#-####
-#--$-$##--#------#
####-#--####-#-##-#
#--#-#$---##-#----#
#-$--$--#-##-#---##
#-#-$-$----#-#---#
#--$-##-##-#-#####
#-$$-----$$--#
##-##-###-$--#
-#----#-#----#
-######-######