 ######
 # . .#
##$#  #
#     #
# $#  #
# @#  #
#######