########
#   #  #
#      #
####   #
 # $$###
 #  +.#
 ######