  #########
  #   ##  #
  #       ##
 ### ###   ##
 #@$   ##   #
 ###  $ # # #
##### ..#   #
#     ### ###
#       # #
#  ###  # ###
#### #      #
     #  #   #
     ########