#######
#     #
# @   #
##$#  #
## .* #
#  ####
#    #
#    #
######