 ######
 #    #
 #$   #
 #@. ##
##$. ##
#     #
#  #  #
#  #  #
#######