 #####
 #   #
 # $ #
## ####
#.@   #
## #  #
 # $. #
 ###  #
   ####