 #####
##@..#
# $$##
#    #
##   #
 #####