######
#  #.#
#    #
#. # #
## $ #
# $ ##
# @ #
#####