#############
#@          #
# . . . . . #
#           #
# . . . . . #
#           #
# . . . . . #
#           #
#############